  x-x
  | 
x-v---x-v-x
  |       |
  x-v-t   |
  |   |   |
  v---x---x